0_0_0_0_0_0_0_0_0_0_0_0_0_0_0_0_0_
0_7_2_2_2_2_2_2_2_2_2_2_2_2_2_6_0_
0_1_0_0_0_0_0_0_0_0_0_0_0_0_0_3_0_
0_1_0_0_0_0_0_0_0_0_0_0_0_0_0_3_0_
0_1_0_0_0_0_0_0_0_0_0_0_0_0_0_3_0_
0_1_0_0_0_0_0_0_0_0_0_0_0_0_0_3_0_
0_1_0_0_0_0_0_0_0_0_0_0_0_0_0_3_0_
0_1_0_0_0_0_0_0_0_0_0_0_0_0_0_9_0_
0_1_0_0_0_0_0_0_0_0_0_0_0_0_0_0_-2_
0_1_0_0_0_0_0_0_0_0_0_0_0_0_0_0_-2_
0_1_0_0_0_0_0_0_0_0_0_0_0_0_0_10_0_
0_1_0_0_0_0_0_0_0_0_0_0_0_0_0_3_0_
0_1_0_0_0_0_0_0_0_0_0_0_0_0_0_3_0_
0_1_0_0_0_0_0_0_0_0_0_0_0_0_0_3_0_
0_1_0_0_0_0_0_0_0_0_0_0_0_0_0_3_0_
0_1_0_0_0_0_0_0_0_0_0_0_0_0_0_3_0_
0_1_0_0_0_0_0_0_0_0_0_0_0_0_0_3_0_
0_1_0_0_0_0_0_0_0_0_0_0_0_0_0_3_0_
0_1_0_0_0_0_0_0_0_0_0_0_0_0_0_3_0_
0_1_0_0_0_0_0_0_0_0_0_0_0_0_0_3_0_
0_1_0_0_0_0_0_0_0_0_0_0_0_0_0_3_0_
0_1_0_0_0_0_0_0_0_0_0_0_0_0_0_3_0_
0_1_0_0_0_0_0_0_0_0_0_0_0_0_0_3_0_
0_1_0_0_0_0_0_0_0_0_0_0_0_0_0_3_0_
0_8_4_4_4_4_4_4_4_4_4_4_4_4_4_5_0_
0_0_0_0_0_0_0_0_0_0_0_0_0_0_0_0_0_