00_00_00_00_00_00_00_00_00_00_00_00_00_00_
00_00_00_00_00_00_00_00_00_00_00_00_00_00_00_00_00_00_00_32_32_26_21_20_18_22_23_18_21_21_27_00_00_00_00_00_00_00_00_00_00_00_00_00_00_00_00_00_00_00_00_00_
00_00_00_00_00_00_00_00_00_00_00_00_00_00_00_00_00_00_00_32_32_26_21_20_18_22_23_18_21_21_27_00_00_00_00_00_00_00_00_00_00_00_00_00_00_00_00_00_00_00_00_00_
00_00_00_00_00_00_00_00_00_00_00_00_00_00_00_00_00_00_00_32_32_26_21_20_18_25_24_18_21_21_27_00_00_00_00_00_00_00_00_00_00_00_00_00_00_00_00_00_00_00_00_00_
00_00_00_00_00_00_00_00_00_00_00_00_00_00_00_00_00_00_00_32_32_15_17_17_17_17_17_17_17_17_16_00_00_00_00_00_00_00_00_00_00_00_00_00_00_00_00_00_00_00_00_00_
00_00_00_00_00_00_00_00_00_00_00_00_00_00_00_00_00_00_00_32_32_15_17_17_17_17_17_17_17_17_16_00_00_00_00_00_00_00_00_00_00_00_00_00_00_00_00_00_00_00_00_00_
00_00_00_00_00_00_00_00_00_00_00_00_00_00_00_00_00_00_00_31_32_33_13_13_13_13_13_13_13_13_34_00_00_00_00_00_00_00_00_00_00_00_00_00_00_00_00_00_00_00_00_00_
00_00_00_00_00_00_00_00_00_00_00_00_00_00_00_00_00_00_00_00_31_33_13_13_13_13_13_13_13_13_34_00_00_00_00_00_00_00_00_00_00_00_00_00_00_00_00_00_00_00_00_00_
00_00_00_00_00_00_00_00_00_00_00_00_00_00_00_00_00_00_00_00_44_36_42_00_00_00_00_00_00_44_36_42_00_00_00_00_00_00_00_00_00_00_00_00_00_00_00_00_00_00_
00_00_00_00_00_00_00_00_00_00_00_00_00_00_00_00_00_00_00_00_38_35_39_00_00_00_00_00_00_38_35_39_00_00_00_00_00_00_00_00_00_00_00_00_00_00_00_00_00_00_
00_00_00_00_00_00_00_00_00_00_00_00_00_00_00_00_00_00_00_00_45_41_43_00_00_00_00_00_00_45_41_43_00_00_00_00_00_00_00_00_00_00_00_00_00_00_00_00_00_00_
00_00_00_00_00_00_00_00_00_00_00_00_00_00_00_00_00_00_00_00_00_00_00_00_37_37_37_37_00_00_00_00_00_00_00_00_00_00_00_00_00_00_00_00_00_00_00_00_00_00_
00_00_00_00_00_00_00_00_00_00_00_00_00_00_00_00_00_00_00_00_00_00_00_00_37_37_37_37_00_00_00_00_00_00_00_00_00_00_00_00_00_00_00_00_00_00_00_00_00_00_
00_00_00_00_00_00_00_00_00_00_00_00_00_00_00_00_00_00_00_00_00_00_00_00_37_37_37_37_00_00_00_00_00_00_00_00_00_00_00_00_00_00_00_00_00_00_00_00_00_00_
00_00_00_00_00_00_00_00_37_00_00_00_00_00_00_00_00_00_00_00_00_00_00_00_37_37_37_37_00_00_00_00_00_00_00_00_00_00_00_00_00_00_00_00_00_00_00_00_00_00_
00_00_00_00_00_00_00_00_00_00_00_00_00_00_00_00_00_00_00_00_00_00_00_00_00_00_00_00_00_00_00_00_00_00_00_00_00_00_00_00_00_00_00_00_00_00_00_00_00_00_
00_00_00_00_00_00_00_00_00_00_00_00_00_00_00_00_00_00_00_00_00_00_00_00_00_00_00_00_00_00_00_00_00_00_00_00_00_00_00_00_00_00_00_00_00_00_00_00_00_00_
00_00_00_00_00_00_00_00_00_00_00_00_00_00_00_00_00_00_00_00_00_00_00_00_00_00_00_00_00_00_00_00_00_00_00_00_00_00_00_00_00_00_00_00_00_00_00_00_00_00_
00_00_00_00_00_00_00_00_00_00_00_00_00_00_00_00_00_00_00_00_00_00_00_00_00_00_00_00_00_00_00_00_00_00_00_00_00_00_00_00_00_00_00_00_00_00_00_00_00_00_
00_00_00_00_00_00_00_00_00_00_00_00_00_00_00_00_00_00_00_00_00_00_00_00_00_00_00_00_00_00_00_00_00_00_00_00_00_00_00_00_00_00_00_00_00_00_00_00_00_00_
00_00_00_00_00_00_00_00_00_00_00_00_00_00_00_00_00_00_00_00_00_00_00_00_00_00_00_00_00_00_00_00_00_00_00_00_00_00_00_00_00_00_00_00_00_00_00_00_00_00_
00_00_00_00_00_00_00_00_00_00_00_00_00_00_00_00_00_00_00_00_00_00_00_00_00_00_00_00_00_00_00_00_00_00_00_00_00_00_00_00_00_00_00_00_00_00_00_00_00_00_
00_00_00_00_00_00_00_00_00_00_00_00_00_00_00_00_00_00_00_00_00_00_00_00_00_00_00_00_00_00_00_00_00_00_00_00_00_00_00_00_00_00_00_00_00_00_00_00_00_00_
00_00_00_00_00_00_00_00_00_00_00_00_00_00_00_00_00_00_00_00_00_00_00_00_00_00_00_00_00_00_00_00_00_00_00_00_00_00_00_00_00_00_00_00_00_00_00_00_37_00_
00_00_00_00_00_00_00_00_00_00_00_00_00_00_00_00_00_00_00_00_00_00_00_00_00_00_00_00_00_00_00_00_00_00_00_00_00_00_00_00_00_00_00_00_00_00_00_00_37_00_
00_00_00_00_00_00_00_00_00_00_00_00_00_00_00_00_00_00_00_00_00_00_00_00_00_00_00_00_00_00_00_00_00_00_00_00_00_00_00_00_00_00_00_00_00_00_00_00_37_00_
00_00_00_00_00_00_00_00_00_00_00_00_00_00_00_00_00_00_00_00_00_00_00_00_00_00_00_00_00_00_00_00_00_00_00_00_00_00_00_00_00_00_00_00_00_00_00_00_37_00_
00_37_37_37_37_37_37_37_37_00_00_00_00_00_00_00_00_00_00_00_00_00_00_00_00_00_00_00_00_00_00_00_00_00_00_00_00_00_00_00_00_00_00_00_00_00_00_37_37_00_
00_00_00_00_00_00_00_00_00_00_00_00_00_00_00_00_00_00_00_00_00_00_00_00_00_00_00_00_00_00_00_00_00_00_00_00_00_00_00_00_00_00_00_00_00_00_00_00_00_00_
00_00_00_00_00_00_00_00_00_00_00_00_00_00_00_00_00_00_00_00_00_00_00_00_00_00_00_00_00_00_00_00_00_00_00_00_00_00_00_00_00_00_00_00_00_00_00_00_00_00_
00_00_00_00_00_00_00_00_00_00_00_00_00_00_00_00_00_00_00_00_00_00_00_00_00_00_00_00_00_00_00_00_00_00_00_00_00_00_00_00_00_00_00_00_00_00_00_00_00_00_
00_00_00_00_00_00_00_00_00_00_00_00_00_00_00_00_00_00_00_00_00_00_00_00_00_00_00_00_00_00_00_00_00_00_00_00_00_00_00_00_00_00_00_00_00_00_00_00_00_00_
00_00_00_00_00_00_00_00_00_00_00_00_00_00_00_00_00_00_00_00_00_00_00_00_00_00_00_00_00_00_00_00_00_00_00_00_00_00_00_00_00_00_00_00_00_00_00_00_00_00_
00_00_00_00_00_00_00_00_00_00_00_00_00_00_00_00_00_00_00_00_00_00_00_00_00_00_00_00_00_00_00_00_00_00_00_00_00_00_00_00_00_00_00_00_00_00_00_00_00_00_
00_00_00_00_00_00_00_00_00_00_00_00_00_00_00_00_00_00_00_00_00_00_00_00_00_00_00_00_00_00_00_00_00_00_00_00_00_00_00_00_00_00_00_00_00_00_00_00_00_00_
00_00_00_00_00_00_00_00_00_00_00_00_00_00_00_00_00_00_00_00_00_00_00_00_00_00_00_00_00_00_00_00_00_00_00_00_00_00_00_00_00_00_00_00_00_00_00_00_00_00_
00_00_00_00_00_00_00_00_00_00_00_00_00_00_00_00_00_00_00_00_00_00_00_00_00_00_00_00_00_00_00_00_00_00_00_00_00_00_00_00_00_00_00_00_00_00_00_00_00_00_
00_00_00_00_00_00_00_00_00_00_00_00_00_00_00_00_00_00_00_00_00_00_00_00_00_00_00_00_00_00_00_00_00_00_00_00_00_00_00_00_00_00_00_00_00_00_00_00_00_00_
00_37_37_37_37_37_37_37_37_00_00_00_00_00_00_00_00_00_00_00_00_00_00_00_00_00_00_00_00_00_00_00_00_00_00_00_00_00_00_00_00_00_00_00_00_00_00_00_00_00_
00_00_00_00_00_00_00_00_00_00_00_00_00_00_00_00_00_00_00_00_00_00_00_00_00_00_00_00_00_00_00_00_00_00_00_00_00_00_00_00_00_00_00_00_00_00_00_00_00_00_